北京 : beijing
秦皇岛 : qinhuangdao
天津 : tianjin
承德 : chengde
平遥 : pingyao
唐山 : tangshan
五台山 : wutaishan
白洋淀 : baiyangdian
石家庄 : shijiazhuang
太原 : taiyuan
大同 : datong
呼和浩特 : huhehaote
易县 : baodingyixian
邯郸 : handan
张家口 : zhangjiakou
包头 : baotou
长白山 : changbaishan
沈阳 : shenyang
哈尔滨 : haerbin
长春 : changchun
呼伦贝尔 : hulunbeier
大连 : dalian
漠河 : mohe
丹东 : dandong
葫芦岛 : huludao
五大连池 : wudalianchi
海拉尔 : hailaer
满洲里 : manzhouli
旅顺 : lvshun
锦州 : jinzhou
阿尔山 : aershan
西安 : xian
青海湖 : qinghaihu
敦煌 : dunhuang
银川 : yinchuan
乌鲁木齐 : wulumuqi
甘南 : gannan
华山 : huashan
西宁 : xining
兰州 : lanzhou
延安 : yanan
太白山 : baojitaibaishan
喀纳斯 : kanasi
嘉峪关 : jiayuguan
天水 : tianshui
喀什 : kashi
额济纳旗 : ejinaqi
拉萨 : lasa
丽江 : lijiang
成都 : chengdu
九寨沟 : jiuzhaigou
西双版纳 : xishuangbanna
黔东南 : qiandongnan
重庆 : chongqing
昆明 : kunming
峨眉山 : emeishan
香格里拉 : xianggelila
腾冲 : tengchong
大理 : dali
汉中 : hanzhong
泸沽湖 : luguhu
贵阳 : guiyang
康定 : kangding
张家界 : zhangjiajie
武汉 : wuhan
长沙 : changsha
凤凰 : fenghuang
洛阳 : luoyang
开封 : kaifeng
武当山 : wudangshan
云台山 : yuntaishan
恩施 : enshi
神农架 : shennongjia
郑州 : zhengzhou
衡山 : hengshan
三门峡 : sanmenxia
岳阳 : yueyang
宜昌 : yichang
南阳 : nanyang
韶山 : shaoshan
厦门 : xiamen
杭州 : hangzhou
黄山 : huangshan
青岛 : qingdao
千岛湖 : qiandaohu
上海 : shanghai
乌镇 : wuzhen
扬州 : yangzhou
泰山 : taishan
婺源 : wuyuan
庐山 : lushan
苏州 : suzhou
南京 : nanjing
西塘 : xitang
武夷山 : wuyishan
井冈山 : jinggangshan
普陀山 : putuoshan
三亚 : sanya
桂林 : guilin
广州 : guangzhou
北海 : beihai
海口 : haikou
南宁 : nanning
深圳 : shenzhen
珠海 : zhuhai
肇庆 : zhaoqing
韶关 : shaoguan
清远 : qingyuan
南澳岛 : nanaodao
佛山 : foshan
惠州 : guangdonghuizhou
从化 : conghua
东莞 : dongguan
巴马 : bama
湛江 : zhanjiang
香港 : xianggang
澳门 : aomen
台北 : taibei
高雄 : gaoxiong
金门 : jinmen
垦丁 : kending
阿里山 : alishan
淡水 : danshui
基隆 : jilong
花莲 : hualian
台南 : tainan
桃园 : taoyuan
日月潭 : riyuetan
澎湖 : penghu
绿岛 : lvdao
台中 : taizhong
泰国 : taiguo
巴厘岛 : balidao
新加坡 : xinjiapo
越南 : yuenan
柬埔寨 : jianpuzhai
普吉岛 : pujidao
马来西亚 : malaixiya
菲律宾 : feilvbin
缅甸 : miandian
老挝 : laowo
文莱 : wenlai
吴哥 : wuge
兰卡威 : lankawei
热浪岛 : relangdao
苏梅岛 : sumeidao
日本 : riben
马尔代夫 : maerdaifu
韩国 : hanguo
迪拜 : dibai
尼泊尔 : niboer
济州岛 : jizhoudao
不丹 : budan
印度 : yindu
斯里兰卡 : sililanka
北海道 : beihaidao
首尔 : shouer
以色列 : yiselie
死海 : yiseliesihai
东京 : dongjing
伊朗 : yilang
朝鲜 : chaoxian
俄罗斯 : eluosi
希腊 : xila
法国 : faguo
土耳其 : tuerqi
意大利 : yidali
英国 : yingguo
瑞士 : ruishi
德国 : deguo
西班牙 : xibanya
爱琴海 : aiqinhai
奥地利 : aodili
荷兰 : helan
冰岛 : bingdao
瑞典 : ruidian
芬兰 : fenlan
捷克 : jieke
澳大利亚 : aodaliya
夏威夷 : xiaweiyi
新西兰 : xinxilan
斐济 : feiji
关岛 : guandao
大溪地 : daxidi
帕劳 : palao
塞班岛 : saibandao
巴布亚新几内亚 : babuyaxinjineiya
萨摩亚 : samoya
汤加 : tangjia
密克罗尼西亚 : mikeluonixiya
基里巴斯 : jilibasi
美国 : meiguo
加拿大 : jianada
古巴 : guba
墨西哥 : moxige
巴哈马 : bahama
牙买加 : yamaijia
哥斯达黎加 : gesidalijia
巴拿马 : banama
洪都拉斯 : hongdulasi
波多黎各 : boduolige
多米尼加 : duominijia
危地马拉 : weidimala
百慕大 : baimuda
秘鲁 : bilu
巴西 : baxi
阿根廷 : agenting
玻利维亚 : boliweiya
智利 : zhili
委内瑞拉 : weineiruila
哥伦比亚 : gelunbiya
厄瓜多尔 : eguaduoer
乌拉圭 : wulagui
圭亚那 : guiyana
苏里南 : sulinan
巴拉圭 : balagui
毛里求斯 : maoliqiusi
南非 : nanfei
埃及 : aiji
肯尼亚 : kenniya
塞舌尔 : saisheer
坦桑尼亚 : tansangniya
摩洛哥 : moluoge
马达加斯加 : madajiasijia
突尼斯 : tunisi
埃塞俄比亚 : aisaiebiya
利比亚 : libiya
赞比亚 : zanbiya
喀麦隆 : kamailong